1,8eight1,8,1,81,81
2,98126,9,6,96,177
3,fourfourthreehnbhkmscqxdfksg64bvpppznkh,6,4,64,241
4,8fivenvvtrlj,8,8,88,329
5,six3zbhvrfhsevennine,3,3,33,362
6,427nine6chnqrssxfour,4,6,46,408
7,threevvxhvx38rktdqm3,3,3,33,441
8,eightzgqzr3eight,3,3,33,474
9,xgjjmnlvznf2nineltmsevennine6,2,6,26,500
10,ninethree15seven,1,5,15,515
11,37cjnsfbfkqpkxpdvgk8,3,8,38,553
12,sgeightwo3,3,3,33,586
13,9sbxg,9,9,99,685
14,1spnthree59ninejjgjdlx,1,9,19,704
15,six9six2gxmn,9,2,92,796
16,twothreefdbl6five3zcqvcqxkcvdfkl4,6,4,64,860
17,46six47seven27one,4,7,47,907
18,four15,1,5,15,922
19,7sixvmsrrzqnngonethree,7,7,77,999
20,3fvsghvkqkbfivenine,3,3,33,1032
21,zhthfghk6ppc48bdx6two,6,6,66,1098
22,1fouronesixsvhbglmvxx,1,1,11,1109
23,7lcsixmzmseven,7,7,77,1186
24,two37sixccrpqngpvthree,3,7,37,1223
25,86fivelqmlmbnhq,8,6,86,1309
26,bvcz4,4,4,44,1353
27,6fivendr7seven31nine4,6,4,64,1417
28,jmkhtgklhpxxblc2slhlnfkoneonefour,2,2,22,1439
29,8smpnsc29threesix,8,9,89,1528
30,r795vgnhqhs92one,7,2,72,1600
31,eightfive6,6,6,66,1666
32,4threeqzslpcvkpfdjh,4,4,44,1710
33,8cthp65,8,5,85,1795
34,twoonenine87,8,7,87,1882
35,dzttdmpfxtnine6onefourone3vnnz,6,3,63,1945
36,8tnnfrsdffpthree67xh,8,7,87,2032
37,seven5seven27hf,5,7,57,2089
38,3sevenone,3,3,33,2122
39,seven9foursskfhnchhf481,9,1,91,2213
40,vrfbrcsgp81vsztr,8,1,81,2294
41,six9dnqqgxtvrngpz7879two,9,9,99,2393
42,lkvzzdxmr71lglsixfour,7,1,71,2464
43,two6jkpz9,6,9,69,2533
44,1sevenpmjfv,1,1,11,2544
45,nlvrdmdhxsix7three7frmdlckfjninesix,7,7,77,2621
46,gfb89qrhtzsfvbnpbp6two,8,6,86,2707
47,f8mbbtzjvrqkrszlgrlzrlrgmbmmrdqv8seven,8,8,88,2795
48,sphkkpptpvjzbflkzz2vbndc3foureighttbn,2,3,23,2818
49,eightnine5zpbzhltpmsxrggdcmbrzkvczqbfsevendtjsr,5,5,55,2873
50,2snpbrhpnine3sevensevenhftpqgk5,2,5,25,2898
51,seventjxr91sevenseveneightwojf,9,1,91,2989
52,1hfkvhjxrtjfivefive,1,1,11,3000
53,3fxgmlxtwo,3,3,33,3033
54,stwoeighttwo3,3,3,33,3066
55,eight45t,4,5,45,3111
56,sixthreecdhbfive3sevensrskjm,3,3,33,3144
57,fiveklmj94sixlhpfztlk95,9,5,95,3239
58,fivefive6,6,6,66,3305
59,fiventjm7tndhd57,7,7,77,3382
60,teightwo87nine83,8,3,83,3465
61,6jskjmxrttwo93four7,6,7,67,3532
62,dftzgsdc19threesevennine3twonevl,1,3,13,3545
63,zmpcgkonethree1cspnkkpjr9,1,9,19,3564
64,hmsfrjtxpgn9dqkr9dqvrtq4,9,4,94,3658
65,3eightmfggjleight,3,3,33,3691
66,qfglzvvrrtpfl4,4,4,44,3735
67,7eightonefpqq3,7,3,73,3808
68,tgtbsmpftwo4hvnvsixfrdqbvqbhspcczfhvqcslvfszvrtzbks,4,4,44,3852
69,twofivesix34nine,3,4,34,3886
70,dhlhkjcjsbgnxd6sgrdnzchtxtplltbqlk,6,6,66,3952
71,oneonegcndlfourdngmbgdeightsix2,2,2,22,3974
72,twotj9l8onetwoned,9,8,98,4072
73,jpz2fourjgrjzf44,2,4,24,4096
74,9fivesixmlqr8rxqpvpfzfive2nine,9,2,92,4188
75,6xkfkrfnine196,6,6,66,4254
76,four7gppqtzvbftzcbzt8nqq1nineqdlrff,7,1,71,4325
77,2threekxgcqjzt4qdbthmjx,2,4,24,4349
78,three61eightrnkckq,6,1,61,4410
79,9knfvqgmdsmdqlkfzl,9,9,99,4509
80,mxsqv6twojgmhpmlfq,6,6,66,4575
81,7fouronelngndbsmljbfzmsix,7,7,77,4652
82,fjm8fdpnlldlgvkqdcdcdjpxzdt,8,8,88,4740
83,7five2,7,2,72,4812
84,tsp9seven,9,9,99,4911
85,eight2hzpkpqrjgcrnxksix,2,2,22,4933
86,jfourcgjbpzbgdn61dzqbgthree,6,1,61,4994
87,7threefive,7,7,77,5071
88,1ncmzhqghthree3sixllvknhf,1,3,13,5084
89,one5six9,5,9,59,5143
90,krzkzmbccr1,1,1,11,5154
91,74mqnzmqnf6,7,6,76,5230
92,four9pfhjktmvxtwo,9,9,99,5329
93,6bl21bpx2,6,2,62,5391
94,4threefdpfqck,4,4,44,5435
95,jjksjbsjlgdonefour5,5,5,55,5490
96,2hbthreegfh1,2,1,21,5511
97,threegzbn1four4hbqkmtmoneightrhg,1,4,14,5525
98,fiveeightnine83,8,3,83,5608
99,3five49jvrhvmnjmmzlzmhpbpsfpn4,3,4,34,5642
100,3vvhshsixone3,3,3,33,5675
101,55three7svtlzzggkqjhjx,5,7,57,5732
102,fxdmnjsvpjbg69gcknlzgrqhqdsxvk3p,6,3,63,5795
103,eightfcnmbzl2jhlklgmlmsevenkjbgzhstwo,2,2,22,5817
104,6sevengdmtlfjmns63,6,3,63,5880
105,ktgqthreedfmrpdvnkfvs3jsgcvtdkh,3,3,33,5913
106,4seven1,4,1,41,5954
107,34onexkninex6pnldxrfs,3,6,36,5990
108,threenine3five9eightrvg9,3,9,39,6029
109,xqbnmtrlsjninenine57rpcsjpqfdcbd6,5,6,56,6085
110,216two,2,6,26,6111
111,xhrdmfcvjzt4sixfkjsvkfhtldfqckj,4,4,44,6155
112,2six8zeight1,2,1,21,6176
113,cmpklgjgf19twoqstfhphbxxtfdgj2,1,2,12,6188
114,lvgqnkqhltwo9r,9,9,99,6287
115,twosevenfive2rgfsgmzqjbnine,2,2,22,6309
116,7ddpjxmfschtqdgnjqc18one,7,8,78,6387
117,oneninefiveeight6,6,6,66,6453
118,qs4five5,4,5,45,6498
119,rpxbcff9vpmlvvrlonefourdnczqzjbvnine3,9,3,93,6591
120,7592r3qjtwothree,7,3,73,6664
121,sixtwoninegzrfp9hq6six9oneightp,9,9,99,6763
122,f8seven1dcrjqchxchfour8,8,8,88,6851
123,bnhmfmsbzbhfive1rfqqkzkptjnnxpone2jqhrfnvkfk,1,2,12,6863
124,qlhpvzdkcfsq84,8,4,84,6947
125,dfour5one,5,5,55,7002
126,hcvxnfm32kpzxkhvmvkjsevenllpjpgdhl,3,2,32,7034
127,dlhhnk2ctvxqmbmsc9five,2,9,29,7063
128,one7sevenninesix,7,7,77,7140
129,two4rkb5sixtx17,4,7,47,7187
130,28three7,2,7,27,7214
131,msixeightnqmtfmtftsix9,9,9,99,7313
132,zff8nineflfpz1six1,8,1,81,7394
133,vk9,9,9,99,7493
134,86ninelzskddf9784,8,4,84,7577
135,mrntnhjrvkjgmntone715ktgb7,7,7,77,7654
136,sevensixthreegkldpptbmteightsix2nfnljvkfkgc,2,2,22,7676
137,nineonenine3ssnjhkhdplvq3six,3,3,33,7709
138,jrdgsz8,8,8,88,7797
139,5nine6bglkndgfnineq,5,6,56,7853
140,nineone8seven5zhdd2eight,8,2,82,7935
141,17qjzvtwo,1,7,17,7952
142,4rncnvtp5ssznhncdnnzndr9,4,9,49,8001
143,6srf,6,6,66,8067
144,5two6xxkzdrbfsix,5,6,56,8123
145,five314sevenseven,3,4,34,8157
146,eightsix7lhfqone,7,7,77,8234
147,gdz3one,3,3,33,8267
148,6sdplqg,6,6,66,8333
149,rsnnm3twoqlxjjvzeightvxszxhmnck,3,3,33,8366
150,7onelvrtdktmcmrm55,7,5,75,8441
151,1eightzvcgfqgfh,1,1,11,8452
152,ssgrzpb6jntxrdhvmrkeight,6,6,66,8518
153,5oneninetwo,5,5,55,8573
154,gjktwopxxql4gxfourseven9,4,9,49,8622
155,four55sevenvglcrqsdt,5,5,55,8677
156,nsqrjfhs2eight,2,2,22,8699
157,seventhree5g9,5,9,59,8758
158,threehvmrmvglvvsix7pqxzfjvv,7,7,77,8835
159,cfgfmgg5vmqnnqrxdxone35,5,5,55,8890
160,two2fxsmdjmb,2,2,22,8912
161,rrlxrkjkxmfrbvxsevenrlllvclhvvfourlp4seven,4,4,44,8956
162,djdoneightthree82eight6five6,8,6,86,9042
163,two4threecdbgnmzvdd53oneeightkmx,4,3,43,9085
164,one5qdtnrpcmrnnsbeighttwotwoninegtpv,5,5,55,9140
165,86htqkfrkmone217,8,7,87,9227
166,onelqd5jvlbm4,5,4,54,9281
167,eightone3rpnkglzfcveight12one,3,2,32,9313
168,fourqfxndmpgbqrcpclbnn86hxsxqrrkjcgtgxbdxjdjlzcrhkp,8,6,86,9399
169,1one18tjcsjzpmzmpmstzmcn9,1,9,19,9418
170,threesevenpgt3,3,3,33,9451
171,four9sixthree1,9,1,91,9542
172,twoninethreesxxqgqlqmqxkmkl2qdrqpftwo,2,2,22,9564
173,seven678,6,8,68,9632
174,two29six958kqxq3,2,3,23,9655
175,dbpjzgdrhnsixfjvs9eightsjdgtckdtsjmhplkjeightwodd,9,9,99,9754
176,7fourninenine,7,7,77,9831
177,fourthreedlhf9rf,9,9,99,9930
178,mjkvfivekltmfourone2,2,2,22,9952
179,7twozrrtg498one,7,8,78,10030
180,4eightcxnx,4,4,44,10074
181,one62eightdktgeight2five,6,2,62,10136
182,bnpxcdxpzp4tklvsm,4,4,44,10180
183,d8sixninegrbx,8,8,88,10268
184,threefourfivetwo23,2,3,23,10291
185,nine3onemqtbrhlp8jqslv66ssjrkh,3,6,36,10327
186,1four9fournine2,1,2,12,10339
187,xfsl83two4,8,4,84,10423
188,65twonine,6,5,65,10488
189,1twofivevctxpfvr18,1,8,18,10506
190,819gc4six79,8,9,89,10595
191,27vtvmsix1phzrone2nine,2,2,22,10617
192,boneight1mskkndkgfive,1,1,11,10628
193,1xmpkmg3,1,3,13,10641
194,one8sixthree9zjtmqjjjtc1nine,8,1,81,10722
195,six36gqjctdsevenlnmmbr7dplrsdptwo,3,7,37,10759
196,8jjvgmffgxr5,8,5,85,10844
197,fivehgkc5,5,5,55,10899
198,2qmbvphfivexggrxljhj9qmjrzmrx8eight,2,8,28,10927
199,3rndntwoseven,3,3,33,10960
200,boneight6tworgxffournine,6,6,66,11026
201,htbvm1grtsgdgbl,1,1,11,11037
202,1hkndcqv,1,1,11,11048
203,32sl9six9,3,9,39,11087
204,894,8,4,84,11171
205,vrhxnstqqmflm6glgfnpfour,6,6,66,11237
206,5ninekrfivesix8,5,8,58,11295
207,5six5,5,5,55,11350
208,eightpdzjhvbgm5oneonetwothmnkflz,5,5,55,11405
209,vnfttnhcs892rmpvjvqvfftmzlkcrzthkbhfour2,8,2,82,11487
210,9twoeight,9,9,99,11586
211,73553bkzzhq,7,3,73,11659
212,fvxmvs47,4,7,47,11706
213,3bhmjpqvzs,3,3,33,11739
214,pcftqc671,6,1,61,11800
215,sixtwo8,8,8,88,11888
216,threesdhhzmxtzpsfgs286nmqpvrtkbktcblqqb,2,6,26,11914
217,7pmhlfcmdxthree11gxpncfqntjtwoone,7,1,71,11985
218,8fivel3sevenxqtpxjntbjbtxhxtqdfnfour,8,3,83,12068
219,6seven72zzseven,6,2,62,12130
220,seven9kcthreetwo2five7br,9,7,97,12227
221,kvkhl1fzvpseven,1,1,11,12238
222,5oneoneeighteight6,5,6,56,12294
223,lvfx6onefour,6,6,66,12360
224,ftjzq4,4,4,44,12404
225,slbgthc5xsxvplbskk,5,5,55,12459
226,64nkjjvrmsqzdone,6,4,64,12523
227,twoonelgcnrmrm52,5,2,52,12575
228,gnfmrdkzoneseven7twotxgsjsix1one,7,1,71,12646
229,1xlrpbbdbdgftkd,1,1,11,12657
230,8jmphpvclbf87two,8,7,87,12744
231,724threesixthreetwozsix,7,4,74,12818
232,bcxdnrd91cprdfcqfive,9,1,91,12909
233,zxjcgbhfr3,3,3,33,12942
234,scfklbckxjggbgz9txqnzf6,9,6,96,13038
235,1twohctsdfkgsdteight2,1,2,12,13050
236,7threethree,7,7,77,13127
237,jdj9,9,9,99,13226
238,99,9,9,99,13325
239,sixfzv24nine2bz,2,2,22,13347
240,onefour1frf79tcfjchqeight,1,9,19,13366
241,onethreenkgjgtpxfkmncvmsqs2bsqppgg,2,2,22,13388
242,fourfourtksqrmnmqfour351lrsnv,3,1,31,13419
243,6559hthdpeightkfive3,6,3,63,13482
244,sixone7,7,7,77,13559
245,eightoneeightjcsggnqthree5qqmp,5,5,55,13614
246,sixeightonegltz7,7,7,77,13691
247,three4plz3kls,4,3,43,13734
248,8sixmssvtthreeseventhreenskzq6,8,6,86,13820
249,tbzxjqxkspseven9dtbqvchseven8mbpznrrh1tdmqs,9,1,91,13911
250,1b7eight,1,7,17,13928
251,thk23eightfivekvzphvmsfour,2,3,23,13951
252,7cnlrjzvk66threefxzrtgrbvmbp,7,6,76,14027
253,bhvponeonefouronedcstbnl8,8,8,88,14115
254,eightninesix4fourbrpfp,4,4,44,14159
255,four29eight,2,9,29,14188
256,kqh5zkgqphzjvz,5,5,55,14243
257,4zvh,4,4,44,14287
258,fivesixnzbsvfjhj2,2,2,22,14309
259,rkrnbpsqjdthreez78mg,7,8,78,14387
260,eight4gzxfdjpnjnskzghlzfdmjhz,4,4,44,14431
261,seven8fourxzdmlcq1mnine7qbblrqtrsq,8,7,87,14518
262,gd369,3,9,39,14557
263,hgtqgfive8,8,8,88,14645
264,pcbgddgvvzpmone4onethreeoneonefive,4,4,44,14689
265,95nnjhmhrqgkkstwo66,9,6,96,14785
266,723sixone9threefiveone,7,9,79,14864
267,threekfvqsscfjr8,8,8,88,14952
268,3vzltxllq65jvthree,3,5,35,14987
269,4977d,4,7,47,15034
270,35pgnlsjjpbgseven33,3,3,33,15067
271,g25twonineeight,2,5,25,15092
272,three8eight3six,8,3,83,15175
273,8five8vjnzglnrbsbxmjqzfvrsoneightlpx,8,8,88,15263
274,3bksdkncgtmdrlvkgboneffkszhfive8,3,8,38,15301
275,five1hfh6,1,6,16,15317
276,fourfoursix2nine9t,2,9,29,15346
277,6onetkhqqonetwo,6,6,66,15412
278,26hdfljh8,2,8,28,15440
279,6onethreefvgnoneoneninefour1,6,1,61,15501
280,jghct6rzcbjsfivefourtsrbsjkgmtfive,6,6,66,15567
281,nine93eightxqknsqhrmjthree2,9,2,92,15659
282,fivenine44sixsixlxdkpm,4,4,44,15703
283,threeeight16jjhdkbhlninekvdvlpbq,1,6,16,15719
284,onethpbzthhlqxnlrmtwo8,8,8,88,15807
285,seveneight1eight,1,1,11,15818
286,5two8,5,8,58,15876
287,4four8vdpmqvf3onenmfg9,4,9,49,15925
288,eight9jtxgdzdrtwovznpmnqvnnlffsix,9,9,99,16024
289,456four,4,6,46,16070
290,9hxkq,9,9,99,16169
291,713kthreexfbdrtbx,7,3,73,16242
292,1five59,1,9,19,16261
293,1mxpmfive63,1,3,13,16274
294,sixfour1ffivezjj,1,1,11,16285
295,97eightthreecjnxblrnine,9,7,97,16382
296,kgqcxfzc4sixnineoneone3eight,4,3,43,16425
297,9fbklklqqsfourbfhmfmgnbtls3three,9,3,93,16518
298,xxjnbdxzeightjqvvd82kfchrthmgkfive,8,2,82,16600
299,zfdeightwokbq3seven,3,3,33,16633
300,6four696ninezfhrbg,6,6,66,16699
301,zrznfshdvlxcstqtghjnjvxq1dlklzghbh,1,1,11,16710
302,steightwoxfbfzlnzvlj7919four,7,9,79,16789
303,nine48oneeightseven89five,4,9,49,16838
304,ninesxtdnjkmg7rn32qdljqprj3,7,3,73,16911
305,five6xkcg1qmpkddfbsnlhzltlqqjr8,6,8,68,16979
306,99sgptmns4five,9,4,94,17073
307,2ninejdstk,2,2,22,17095
308,gvclfcg9,9,9,99,17194
309,n9lmv,9,9,99,17293
310,jrftwo3,3,3,33,17326
311,sxrxlnvdhr47dppck,4,7,47,17373
312,jvtwonesixlzdshrfjtzgqddsix7,7,7,77,17450
313,7peightoneeightwobsc,7,7,77,17527
314,three6txdjgqqmsdeightcxmljmmzxksseven,6,6,66,17593
315,fqpx9three96xrvjvjjnrhknsvfour,9,6,96,17689
316,9fournjmslzbmx34cnt,9,4,94,17783
317,f3twovfc,3,3,33,17816
318,shbtwone3kzdsdrxgr,3,3,33,17849
319,4five1tfhvd27,4,7,47,17896
320,rdccbvkr9gjsmxhfdzgvjcbkdmsdeightlvjkdgtdqmbvscvhpmdz,9,9,99,17995
321,pzsqhqthreetwo1qxfbhreight,1,1,11,18006
322,threeeightxonenineninepmjfgzsdhd1,1,1,11,18017
323,nine7sevenone,7,7,77,18094
324,hbsqqtlqcxkjjccmmpv5,5,5,55,18149
325,6nineltr5plmbgzfqbxninerxzbzrblmfsmjggvr,6,5,65,18214
326,5eightwolxp,5,5,55,18269
327,5cscpfqm,5,5,55,18324
328,four3nthbmbxfbvtrqqkfmltmtjh,3,3,33,18357
329,pvxtx89jp9onesevennbxmjlzmfk,8,9,89,18446
330,threetwoeightzcgkbv1,1,1,11,18457
331,7rxxfpgvl3eight8dmhkf,7,8,78,18535
332,nine6two,6,6,66,18601
333,tpnr21five1eight,2,1,21,18622
334,ktsx6threeseven,6,6,66,18688
335,8four31drvszglmv,8,1,81,18769
336,fgkmbcgsrjgs6eightfivefqqdksrndrtdbsxgmfgtggmrc,6,6,66,18835
337,sixnineninefzvthdq5tkzrhrgdqblzndmv,5,5,55,18890
338,7lfdrntqsm,7,7,77,18967
339,seven8dgxgqvgvmtdkhqsfkhtqcjpvqlfnine,8,8,88,19055
340,znltfour6twopsdmcthree,6,6,66,19121
341,oneeightvvvxxptmk4eight2n,4,2,42,19163
342,5six1jmmqtknpveight,5,1,51,19214
343,eightsixxxpbvqhpknz27mqxvf,2,7,27,19241
344,rbdchcmqhseightnine9,9,9,99,19340
345,944five8gxsjf98,9,8,98,19438
346,smdhcnbmone9,9,9,99,19537
347,one64six,6,4,64,19601
348,seven4fivesevenfournine,4,4,44,19645
349,fivetjt27qqxncqcone,2,7,27,19672
350,five49655onet5,4,5,45,19717
351,mlqgmhfgsix3two2,3,2,32,19749
352,jxdfkbvdgnjqznineh1rdqsv7,1,7,17,19766
353,fqdvcktwoeightsixsevenkkczb3,3,3,33,19799
354,3krndk27,3,7,37,19836
355,qjpmscfqf2gzgvzgksc,2,2,22,19858
356,5zs11fourqqzfour,5,1,51,19909
357,5h,5,5,55,19964
358,fourtjzxtgrtd2twokrkpfm,2,2,22,19986
359,fourgxprrlvmhgpggsmzbone7,7,7,77,20063
360,ldbprdzrqkgqkx23pjvgrc6,2,6,26,20089
361,ninevfh2seven4four,2,4,24,20113
362,23gfmpvvsrjr4vlntkxkeight,2,4,24,20137
363,sevensixonefivefour9two,9,9,99,20236
364,vmchfrmfntwo3sv1twoonenngblvmjsf9,3,9,39,20275
365,sqhzppseven79kzdppfnk8foureighttwo,7,8,78,20353
366,1ljltwo8xhszxqmtponethreesevendkx,1,8,18,20371
367,4fourfive,4,4,44,20415
368,5fpzhcd7pmbcxcrkp,5,7,57,20472
369,cdhqgkhfive61seven,6,1,61,20533
370,eightqtzrscqhr3,3,3,33,20566
371,brrftwothreethree1,1,1,11,20577
372,r145pbthqtvxd63,1,3,13,20590
373,ninebdnxdvchzf57oneightpp,5,7,57,20647
374,7one1three68,7,8,78,20725
375,five8nknine341msfflpnz,8,1,81,20806
376,sixxmsevennm6,6,6,66,20872
377,2n5cdvvtghfg2lmfrbjbvtwothreefour,2,2,22,20894
378,39one16,3,6,36,20930
379,l3two,3,3,33,20963
380,xsmtghfiveonesix6lkzfgq4threethree,6,4,64,21027
381,6onettqbfp,6,6,66,21093
382,nhxlqqp3vkcgsjgkgmjrpll,3,3,33,21126
383,xgbzrtkbthbfour7mptxqnbrkvhninetwo,7,7,77,21203
384,7foureight55cvpgsvsr,7,5,75,21278
385,3twonine,3,3,33,21311
386,gsqhbhfrzfour9twovjjbskdonegseven4,9,4,94,21405
387,2fourthreedcxrcmjmkprdsbone5one,2,5,25,21430
388,519955six,5,5,55,21485
389,two8fjgvtwo7vnttwo5qzlgxcfkz,8,5,85,21570
390,rvk4eightthree,4,4,44,21614
391,9six6,9,6,96,21710
392,clpxqfn3kcn3,3,3,33,21743
393,1pzbkzdn9sixxlq89tcnm,1,9,19,21762
394,nineninetwogtsjfour2twollrrllvk,2,2,22,21784
395,three5ql7hdjkxdbrcqsfouronekqhc,5,7,57,21841
396,ltgeightwothree5ccxbhssxrsbj,5,5,55,21896
397,42three3,4,3,43,21939
398,dkmm8eightnine4five,8,4,84,22023
399,vqmvzpb9tmmsfgscfive6mtjjbleightfour,9,6,96,22119
400,ms39zmtbptwofive,3,9,39,22158
401,4xxxkdxlhjjx,4,4,44,22202
402,6p,6,6,66,22268
403,threejfqfjhxp9txlrlrbczdxzpmrkz9sevensjlgstbpffhtb,9,9,99,22367
404,three2zqtrtpzvsffdkjsevencjmrdqthree6three,2,6,26,22393
405,two681,6,1,61,22454
406,fourlhcsspzf5fivezgzkclbrdrqdjcksfive8,5,8,58,22512
407,ss3,3,3,33,22545
408,znrzctdlgjpzszsixzssrfpcvhlbpg8spfxsgbctpttbxxxsc,8,8,88,22633
409,mjfsxjtthljlzzjlxspdsgsstltmlxf6,6,6,66,22699
410,48zvpktkpk3,4,3,43,22742
411,7khsdbtp43rgggnxf,7,3,73,22815
412,2ninedkttzmpqddsix,2,2,22,22837
413,xjcqvkcnbpbqsmclfnsdbnnine3eightfive,3,3,33,22870
414,7eight6,7,6,76,22946
415,eight8zqcdbzqfour3,8,3,83,23029
416,one8eight27,8,7,87,23116
417,ninemmheight3jdkktmthree,3,3,33,23149
418,oneeight3lbsrnqrn,3,3,33,23182
419,8ninefive71,8,1,81,23263
420,hd58sixtmdj,5,8,58,23321
421,fivesevenfourtwo4,4,4,44,23365
422,fivecdsvgkfgbntwo42,4,2,42,23407
423,593jxn,5,3,53,23460
424,sevenfxkvdxfjgskjhhphnjrgfhs8sixcnine2,8,2,82,23542
425,fourtwo2sixthreefive7rq4,2,4,24,23566
426,threesixdhlkvz3fvdslkbs3,3,3,33,23599
427,nine3fkrzbjbmjbsr,3,3,33,23632
428,nine7seven36,7,6,76,23708
429,sevenbnncfhrnzq52eight6lvfdmqhxkdqjl6,5,6,56,23764
430,zshsmpsmbzpnfthree1five72fivetwo,1,2,12,23776
431,threenine59seventkthreeflgkvtp,5,9,59,23835
432,nine9nine6,9,6,96,23931
433,8five4foursix4,8,4,84,24015
434,jnz1m3fmzzgt9kbtpr,1,9,19,24034
435,81btdvrcspvfour,8,1,81,24115
436,three1smvpjdnhveight1sevenfour5rqkqvq,1,5,15,24130
437,49fiveeightonefive,4,9,49,24179
438,2xmdtnineczgbqmhfivef1six,2,1,21,24200
439,638nine,6,8,68,24268
440,eightsix6twooneseven,6,6,66,24334
441,jgtwone6gzchdrkts,6,6,66,24400
442,93tsrvf48,9,8,98,24498
443,1qkrdfhpseightninelddrnffp2gc,1,2,12,24510
444,nqvkkprztqsqfk74threeseven5six,7,5,75,24585
445,14two,1,4,14,24599
446,dmhnlgxqpjxxvpshqt2sevenplzbgvsz6,2,6,26,24625
447,bffour72,7,2,72,24697
448,zgkgvone8bxsnnlninegmjtnsqtdp,8,8,88,24785
449,19oneninezm88blmdhbcrns,1,8,18,24803
450,2fivessqk1fonevghgnz,2,1,21,24824
451,ddszqsldhxpsbprdbqkmhs6ztkbzbkm8cddpqm2,6,2,62,24886
452,7eight5xhdtpfive6mbf,7,6,76,24962
453,qxcnnmdt5vctqqhmvrmqblsixfour72,5,2,52,25014
454,6onetworpstxdq3tvrcmssmkfhbr,6,3,63,25077
455,7twoeight1,7,1,71,25148
456,64two3sixsixckbkshnkjmtwo,6,3,63,25211
457,7csixonegdbrvreight,7,7,77,25288
458,bfdptjcjdq4five7sevenfdhhqhseveneight,4,7,47,25335
459,8one8dzbninethrmdldmpn,8,8,88,25423
460,three7xghxhr1threerqfxseven,7,1,71,25494
461,two9xrhvzkgcck3vfour,9,3,93,25587
462,5lvtrgmpttk3fourfour,5,3,53,25640
463,five581cjndb,5,1,51,25691
464,3clp81dhzcbzxc,3,1,31,25722
465,threesixsixbtst27,2,7,27,25749
466,fivesixnines146,1,6,16,25765
467,gppzks5cqggtq,5,5,55,25820
468,4rgdzsnqlcxone8vninegkgqh5fcbsfl,4,5,45,25865
469,jfpdpfcccrjpcfive2threeseven,2,2,22,25887
470,ninefoursix6sixtwooneone7,6,7,67,25954
471,twothree3njhxgc5rhntgnckg,3,5,35,25989
472,3twopvtmvrcrnr238,3,8,38,26027
473,k4mgzqbnkrthreeseven9,4,9,49,26076
474,bzkoneight2jxllsevennmhxpgbdkfive,2,2,22,26098
475,886svgcltdl222,8,2,82,26180
476,sevenqjgkjdfrrskhklvrg9fourtwofive,9,9,99,26279
477,cdsfdkdsvtcjhzdpqdgtwo454five,4,4,44,26323
478,lmksxbv8foureightbxskfblhllsdrxfs4v6,8,6,86,26409
479,49sixfour9nine15two,4,5,45,26454
480,75mtcmthreelvmsksnine9,7,9,79,26533
481,foureight849zgl69,8,9,89,26622
482,92eight6ninezjfive,9,6,96,26718
483,8onejsfvnjktqksixlfnxqrjmdvt8vhttwo,8,8,88,26806
484,48three,4,8,48,26854
485,onesixcksvcdeight3tr,3,3,33,26887
486,hvxqb1fourseven4,1,4,14,26901
487,four755grdsixthree,7,5,75,26976
488,seventwokzpljzth6mzkvsdbgldfbdc,6,6,66,27042
489,ninexjgzkcxl3sevenfive,3,3,33,27075
490,949klmgj3,9,3,93,27168
491,53threethree,5,3,53,27221
492,lzczjzsftmcmclqqbrgjftfhxz3,3,3,33,27254
493,9rpzfnrseven3tsqxxgtrsq,9,3,93,27347
494,fcndgzmtsj86psclvsdvggbhfhd8five,8,8,88,27435
495,qxkd2lxzhhcjlxonel48ndktqt4,2,4,24,27459
496,2five5twovplrbfxfjzvmdvjs96,2,6,26,27485
497,4drtzsix5phvgbqjsknnine9fk,4,9,49,27534
498,btmdjvnkrqxvjzchkkdpqcnldljs7eight6znfphg,7,6,76,27610
499,xtrjonefour8threexksbbvkxmkthree,8,8,88,27698
500,sixhtxkz7pnfzsnpnxnine79,7,9,79,27777
501,eight5826,5,6,56,27833
502,hrxqbqq5sixkrdjszbblnpdhfour,5,5,55,27888
503,xlcmcgprrp2,2,2,22,27910
504,seven4vfm3,4,3,43,27953
505,bztngjjhfivethreenineeight5,5,5,55,28008
506,oneonedvgbrpgqrnh77,7,7,77,28085
507,jfnphpvcggfour5zoneeighttjxhcqhsml,5,5,55,28140
508,796fcone4,7,4,74,28214
509,7fivetrmdsb,7,7,77,28291
510,2fiveseven,2,2,22,28313
511,fmtdrcczngfivefour6fiveqbkn,6,6,66,28379
512,eight25lxjdzkrrqj,2,5,25,28404
513,fiveninefour373,3,3,33,28437
514,fournr2kzbls1tghseven,2,1,21,28458
515,3nlmhvbninenine1fourpppthree1,3,1,31,28489
516,j4fourtwo8,4,8,48,28537
517,one2f1oneightc,2,1,21,28558
518,8g2six8,8,8,88,28646
519,nineqzlsxdktwokdhsevenpkqqhjb4jz,4,4,44,28690
520,cqsnztq6hjvkcnpxhmplfxfv,6,6,66,28756
521,6svktmthzeight1nfxldggeightqfmhhzzsdthreesix,6,1,61,28817
522,five7six9,7,9,79,28896
523,thlhmgvvrmqv9,9,9,99,28995
524,fourpvksthrjlxxdddseighteight55,5,5,55,29050
525,qsccghmztwosevengcrfqnzzmrhbgrxlrsxqxtmthbv7three1,7,1,71,29121
526,onetwoj19eight1,1,1,11,29132
527,8xgtltlrbnscvtone5nine4,8,4,84,29216
528,ftx5,5,5,55,29271
529,knsvnknplxrgtnrlqcl5,5,5,55,29326
530,nflmxkm2dznjhp7three8,2,8,28,29354
531,five2tttpdfnmdx3fdrtmxzqx38three,2,8,28,29382
532,two3onegkj,3,3,33,29415
533,47fivekd,4,7,47,29462
534,six9one5nine,9,5,95,29557
535,l3onegpj8threekkgdkfzscrrx,3,8,38,29595
536,four4ninekfndgvhrrbfzpzrnvpzlxss2l,4,2,42,29637
537,ltgsxcrgzqrfpkkb3oneeightfive91knzsppbbx,3,1,31,29668
538,sevenvplfzkncmzninenine1,1,1,11,29679
539,sixhjjsxgrkgstwoeight1knhgsmscrnpcsone4,1,4,14,29693
540,1jbm89two63two,1,3,13,29706
541,onedmpxhvvcjssixeightkpvdmzjltwo3eight,3,3,33,29739
542,fivevjjtfeight6nine6,6,6,66,29805
543,thffrjkhsixsix1one7one,1,7,17,29822
544,dbpvngh3eighteight86foursix,3,6,36,29858
545,pppcpjmbmhsvhjmkfour2onedlnrg,2,2,22,29880
546,2onev8,2,8,28,29908
547,55gpvxsvsnpfrpmn,5,5,55,29963
548,lfsmfbone58,5,8,58,30021
549,tv48threetf3,4,3,43,30064
550,8threeonefour71,8,1,81,30145
551,ghfslsb73dtlgjnj,7,3,73,30218
552,565twofive7,5,7,57,30275
553,sixljhfccjg5eighthpskg,5,5,55,30330
554,5four2four988rd,5,8,58,30388
555,xtgtb99,9,9,99,30487
556,kkzfxjszrfjvqllzlhzsninehzbfbvnhtzjf2,2,2,22,30509
557,165,1,5,15,30524
558,3jtklkpsfxpxlrgltwojxcpqjdsfbs,3,3,33,30557
559,three7vknxbtthree,7,7,77,30634
560,7fourfourfive,7,7,77,30711
561,sevengseven71nklkzdeightsevenfive,7,1,71,30782
562,eight37one,3,7,37,30819
563,onenine2,2,2,22,30841
564,8nine9vkxxhnm6threethree,8,6,86,30927
565,7one96fivesix,7,6,76,31003
566,58bjnfhjxsm146six2mzv,5,2,52,31055
567,99jdqbtb5seven,9,5,95,31150
568,8mqztm7bdjh4,8,4,84,31234
569,6ninevninenvxflxvgg,6,6,66,31300
570,k2twonek,2,2,22,31322
571,gzmtwokrk9ptrsixfjbktjc9,9,9,99,31421
572,8fivesix,8,8,88,31509
573,onesqqkvdtrs5vrsbgnvkjseven,5,5,55,31564
574,bnbxpqhqxthree79,7,9,79,31643
575,nine5l96ninesixqhtxpkzb6,5,6,56,31699
576,sevenfive8tklnkqtwo6three,8,6,86,31785
577,qb2onenldzvsixdjmjzdfourqgjsssr,2,2,22,31807
578,thqmrjnjg3dbnksktvk,3,3,33,31840
579,318,3,8,38,31878
580,three71blglscfrzql3six,7,3,73,31951
581,9nine6nine4,9,4,94,32045
582,sfive1seven1m,1,1,11,32056
583,five3dj16,3,6,36,32092
584,5ninetwotwo8srrvkx3,5,3,53,32145
585,spcsttljpl7,7,7,77,32222
586,6rslsdkfs4834,6,4,64,32286
587,dshfour8knjplkghpfpzcszqsix1,8,1,81,32367
588,ninephtlxnnl8hzn,8,8,88,32455
589,bmr5,5,5,55,32510
590,tm4czfdfbhps,4,4,44,32554
591,sevenseven4three9sixtsmg,4,9,49,32603
592,sevenprdqm1six47cnbskdfivethree,1,7,17,32620
593,7one6gzfdvfvfourtwoninelbndhdkqeight,7,6,76,32696
594,jzxczvgjgxdfrzn2nineseven,2,2,22,32718
595,zpcspqvhbfxlcgt1onesevenqktvgjhm,1,1,11,32729
596,bmzdhnljms4nkjzhkrtfzngbn,4,4,44,32773
597,nine6mjfbftpcfh4five9eight,6,9,69,32842
598,qrvsldss4nine4,4,4,44,32886
599,lffkvnhbpbtnxzncjs4,4,4,44,32930
600,76ckghqnbsnlnjftwo72,7,2,72,33002
601,7jrqrkdksixsixtwonett,7,7,77,33079
602,3xc,3,3,33,33112
603,mzveightwofive2onesix7five2,2,2,22,33134
604,74five6mrqx464,7,4,74,33208
605,qtwoqlrkvlmpqfjvm8onetwo,8,8,88,33296
606,41bchstnlzkntwonineseven1pskh,4,1,41,33337
607,twoonejtjph15three,1,5,15,33352
608,fzmkkgdq6,6,6,66,33418
609,21one,2,1,21,33439
610,eight59fivenine,5,9,59,33498
611,jbfmfbseightmzlknl84,8,4,84,33582
612,four4rlzplmmmcplfour4mllmtxx1,4,1,41,33623
613,q349j,3,9,39,33662
614,6dbpqgttninepx623bpbhsnxcmg,6,3,63,33725
615,52hvsvpk,5,2,52,33777
616,8fivesevengzz,8,8,88,33865
617,3fourfnfldsxngrknxnvts,3,3,33,33898
618,18s,1,8,18,33916
619,three2561b1onethree,2,1,21,33937
620,zlppzxzzsixtwo4hksclkzhtkdsldfgjhtfhxcdsmdbr,4,4,44,33981
621,26eight65five9threeeight,2,9,29,34010
622,seven178,1,8,18,34028
623,fvljxzhdln11eight,1,1,11,34039
624,49four6fourqmspqkbphjzvgzgbvrbmjfsm,4,6,46,34085
625,onelnmplhjtjtfivesqzn7qmcpchjtxfcc,7,7,77,34162
626,hd8,8,8,88,34250
627,9pnneight,9,9,99,34349
628,five1qgdzkj9eight,1,9,19,34368
629,rfhbnhbkzteightfivesixtwo3,3,3,33,34401
630,bczljcceight2,2,2,22,34423
631,145sevenhmfive,1,5,15,34438
632,8lbgkvdxlccgzzvvttcfgmthreehhmqfivexcdhdd,8,8,88,34526
633,6bqxzzzgpdk48,6,8,68,34594
634,twobcxchbfour5m2two1seven,5,1,51,34645
635,twotwotwo6513fg,6,3,63,34708
636,48one6tmjxclchtnpltmjkpmmm,4,6,46,34754
637,vhkcklgdhk9xmvtbktdvjmhjtwoned,9,9,99,34853
638,eightfourfour9one7,9,7,97,34950
639,fourqhgjdpr4p3sevennine,4,3,43,34993
640,vlctnqfour4724,4,4,44,35037
641,9spbtvbsh7scvvx7hvbxlh,9,7,97,35134
642,eightone1ccdhppbsninejfktrxst,1,1,11,35145
643,448fourhjk3r3mhstwones,4,3,43,35188
644,hbgfourtkvg87sixlcvtjz,8,7,87,35275
645,fivesphnkzrn5threeninefive27five,5,7,57,35332
646,92two95seven5,9,5,95,35427
647,twosix84zjqtp,8,4,84,35511
648,9bxppvsjgdmbqvkstrqdsixtwofourfour,9,9,99,35610
649,fourfive3sixnine9gmrdhfhkjtrnbl8,3,8,38,35648
650,gxcdvsjxgll46mrrdfpdkdl,4,6,46,35694
651,4foursevenzklvhrdvpj,4,4,44,35738
652,seven1rz24rfmnjxjkthreenfvjdsjtgqkd,1,4,14,35752
653,2xbfivelpfhvhsttgjqfsqkffctppeight,2,2,22,35774
654,6vxfjbssixfkjqsdh83xgzdmtntgm,6,3,63,35837
655,5four98two,5,8,58,35895
656,xdk6,6,6,66,35961
657,ptxtvnlpxbpkxptbhxheightfour7,7,7,77,36038
658,6four5sqgfour,6,5,65,36103
659,eight8rbngtqpvninelzhffxpmtwoonefourfour,8,8,88,36191
660,three1eight2,1,2,12,36203
661,1two8nine,1,8,18,36221
662,9eight82,9,2,92,36313
663,5fourshdfivefpfd3,5,3,53,36366
664,two667dsmv3lvhszg4,6,4,64,36430
665,kcxpmrv99threeone,9,9,99,36529
666,seven7five3ninerhjbmtfbzsevenfive,7,3,73,36602
667,4four1threegvxkdsfour,4,1,41,36643
668,qdqrgf6fourfour46,6,6,66,36709
669,7nlztdphcjdnqm4zddjhfreight,7,4,74,36783
670,sixthree62,6,2,62,36845
671,vs86four,8,6,86,36931
672,sssbdgzsjnlftms8,8,8,88,37019
673,3ninethree45twofsfsvtnl3three,3,3,33,37052
674,four7zcfjtngsninethreeninethree,7,7,77,37129
675,gcjxkcnsevenfivefourhrxzvxftnine4sixzm,4,4,44,37173
676,thsdcone23bvrfour71five,2,1,21,37194
677,fiveeight5fourrlhjtmrtwo36,5,6,56,37250
678,61lxhrpfvbqkd,6,1,61,37311
679,55three5seven1,5,1,51,37362
680,sixsix9,9,9,99,37461
681,gklpxzmcmnnbhsgeight63,6,3,63,37524
682,fourninelxm5cpkqvbpbsvjndn4,5,4,54,37578
683,hcjghqfssevenxzdljnvqsix1sjvrhxxhxthreesix,1,1,11,37589
684,rtfttcqmxszrsixtwo37scglpjfjt5,3,5,35,37624
685,eighthvbsldnhfzxr7eightsrmqhsgonebx,7,7,77,37701
686,zcvqxjn1vdddlsevenninefourninethree,1,1,11,37712
687,qr7three3two4tdrqd,7,4,74,37786
688,qbjttlfsrrrhrmkhpvgc7zkone,7,7,77,37863
689,6fiveseven7ndfhzxzrrf,6,7,67,37930
690,fkxhpzb568eightspdxfngrp82,5,2,52,37982
691,seven4sixtwo,4,4,44,38026
692,nineddhgjn4,4,4,44,38070
693,37chjlxcbbjrjghzjdsix4threeone,3,4,34,38104
694,jhngdhntvfmcbjjvlgx979,9,9,99,38203
695,9thpnx12835one,9,5,95,38298
696,onesixfzjgpfourseven1nine2jrxjp,1,2,12,38310
697,5rzvhjqnlvnt1lone,5,1,51,38361
698,9dmftktf9,9,9,99,38460
699,eight5eight,5,5,55,38515
700,grkfgrhnkjm9,9,9,99,38614
701,23ksknkqrdthreecvg2rbxkkhlqttfivefive,2,2,22,38636
702,3foureightshnff5six72,3,2,32,38668
703,19ninethreebcgxkmjqhgpmfx3,1,3,13,38681
704,28rdsm5fiveeightthree,2,5,25,38706
705,dmgpjdzfl1two819,1,9,19,38725
706,pbrvnfpftb3vptbqncmqszbbctnj363,3,3,33,38758
707,fzdc29331,2,1,21,38779
708,bnkjk9m289rxgqn,9,9,99,38878
709,fivenine4seven6plsczmxr4,4,4,44,38922
710,fourmxrltjgdleight1three,1,1,11,38933
711,nvjxvpgtplgszgbeightcccxxjhbsfqdrj7,7,7,77,39010
712,5stjbvxglkdrbp6kllbbnptdfzl,5,6,56,39066
713,dmtpxndvvrbksfournine5one6,5,6,56,39122
714,vnlhxcssevenjlfgfournine69hmnddrthree,6,9,69,39191
715,blchmddjmktwo4fxsqlpfn69xhbpblrlmone,4,9,49,39240
716,17qdxzqlpllfourszcpxmtcxhrqzqqhm45,1,5,15,39255
717,fchdhsjzt6two9,6,9,69,39324
718,srs3vcq7three,3,7,37,39361
719,twotwofour4seven,4,4,44,39405
720,three4six8lsdg1,4,1,41,39446
721,1fdvdhxrxmmvzonehmkzspfdlrdvlnfzfive9,1,9,19,39465
722,7threeone,7,7,77,39542
723,96ninegjcxpstqhxbdzfsrczm2,9,2,92,39634
724,xthree19,1,9,19,39653
725,bgptbh73sixfour,7,3,73,39726
726,eight82,8,2,82,39808
727,sevenb3sixthree9zjflmmdjfour,3,9,39,39847
728,kcninefour2ninetzqgrztwojq,2,2,22,39869
729,eightfourhfqttttxteight5,5,5,55,39924
730,zghnvzdpfivevvgfjzfzvcbvccmtwo5tkzj7,5,7,57,39981
731,33qxzctgqsvxnine9,3,9,39,40020
732,6onejdndbcjsseven,6,6,66,40086
733,294xqcrnine3844,2,4,24,40110
734,two6ssqvnvm889,6,9,69,40179
735,rzfbhbr15jpnfqmzthreepnine41,1,1,11,40190
736,eightjlltprrrtv63twoptg4,6,4,64,40254
737,threetwolzdbgcpkm3seven1five,3,1,31,40285
738,mcbjrtbtbp7twoseven7vdttjvmxbxkfmgmvhrs,7,7,77,40362
739,three5hfivesevenqrc6sbst,5,6,56,40418
740,eightdvvtsvmfqeightfz5six,5,5,55,40473
741,kklpnghzsfv88two86eightplfgjz,8,6,86,40559
742,bcgntz6gqxbxxtnnonegqlz4fivexmjxqf,6,4,64,40623
743,mvbgjpsmhntf7mmshslgvv17thlknqfivel,7,7,77,40700
744,fourmjflcbtwo7fivetdntjstntv8,7,8,78,40778
745,89fctlsxz8eight,8,8,88,40866
746,1twosix57sevenfive,1,7,17,40883
747,3ninefivencdgmlqxlnine96,3,6,36,40919
748,twofoursevensixeightpmpfpfljqtnm9six,9,9,99,41018
749,5hqnxvlmnh1bxxhnpkjhgzxlhgffv,5,1,51,41069
750,nine9fourtwo8tzseven,9,8,98,41167
751,grcfkddgseven55g,5,5,55,41222
752,seven8nineeight4one7lnntwonebc,8,7,87,41309
753,one1ktgggr,1,1,11,41320
754,76eighttwoqzfnllqnkq,7,6,76,41396
755,cgjkzlksl1823749,1,9,19,41415
756,9twonvhlhrlxnine7eight,9,7,97,41512
757,qtzmndkrqqcpmjcxz98kklrtjgbbnzglstnnlnqksrgkzz,9,8,98,41610
758,cqxknrmb5cfhfgpk,5,5,55,41665
759,9lhrnlqrnninethree,9,9,99,41764
760,ftlpbv55nine,5,5,55,41819
761,2nine5tfqhqtwo,2,5,25,41844
762,mqcfgssixtwofour6cvncgmxnlq,6,6,66,41910
763,946eight84kvflb,9,4,94,42004
764,h1nineglvgmh9txxg8,1,8,18,42022
765,lxqqqdfive5mcgrjkxmlzdqbkldjqkhlxnbg,5,5,55,42077
766,jjkvdzzkpxqp1three59dqthvgkfmfjvlvnrtlzlmqvcspjfc,1,9,19,42096
767,sixfoursix87oneoneseven,8,7,87,42183
768,1ptrtgd6,1,6,16,42199
769,5threeeightqqjrmchfoureight,5,5,55,42254
770,one42mdmfkrzln5ck8qxbfqf,4,8,48,42302
771,seven819ninejzrddsevensix,8,9,89,42391
772,vfpeight4pngqpbvsbz,4,4,44,42435
773,threesixseven1,1,1,11,42446
774,7twoonetwo9eight88slpctv,7,8,78,42524
775,fqfsixtwofpm14seven,1,4,14,42538
776,6xcdvsftlsrsrgseven5seven,6,5,65,42603
777,mhmgzdgrc6lnnzv6pnr4stxnmrreightblzp,6,4,64,42667
778,9glsqqcrttdgsdqkfour,9,9,99,42766
779,82two,8,2,82,42848
780,ftqzqnlddctlxmb3rdlg,3,3,33,42881
781,sevencxbpxvznqmjqgglfccqkvjqmjbpthreenineeightnhszbvnff7,7,7,77,42958
782,twosixplgdjplfthree9kvhvnzzqzk,9,9,99,43057
783,1pfvkfblrmz,1,1,11,43068
784,2n,2,2,22,43090
785,threeeighteighttwo7qmlnjx,7,7,77,43167
786,6sevendhc6,6,6,66,43233
787,nineklzvllx3fivesix,3,3,33,43266
788,2nrrx5fourfcljkdhpk,2,5,25,43291
789,eightone9eight,9,9,99,43390
790,gqhsmccbpjc46twooneighttbv,4,6,46,43436
791,sixtwo2bxpdqfour5fivexkjxzb8,2,8,28,43464
792,six4nineggtqsxjd16mhgpjflprmsix,4,6,46,43510
793,tndgkrpmfour1foursevensflkzt,1,1,11,43521
794,bpxtdkrcr5nsevendltgfgkzxdtbxsghkkninesixone,5,5,55,43576
795,one22threefivetwo,2,2,22,43598
796,lzq7fzbqsd49,7,9,79,43677
797,cgthgcsix1,1,1,11,43688
798,389seven,3,9,39,43727
799,cmgctmtwo8eight,8,8,88,43815
800,2qvrbrnvp559,2,9,29,43844
801,eightjpkjnpgplseven7oneightdv,7,7,77,43921
802,cdzoneightsevensixeightmfjsevenk2eightfour,2,2,22,43943
803,2sgtftmrrlfhgqxdmhtfqncslmnlvdhnjpdtpg45,2,5,25,43968
804,fiveone1,1,1,11,43979
805,ps2threeeight9hvmjrc3,2,3,23,44002
806,pdsr2xphzmmztnqxpzq,2,2,22,44024
807,nineeight7ninevhlksv,7,7,77,44101
808,jjbsm55fscpfpklq1sixseven,5,1,51,44152
809,fivefive1nkpzcxrxbfour,1,1,11,44163
810,fivesixdkxvbtzvtlsevensix3fivekh,3,3,33,44196
811,twovrzxlmnxnhonedpdmvn9,9,9,99,44295
812,hmqccxh6,6,6,66,44361
813,five6nine8vcbzzqrvn29,6,9,69,44430
814,5nfmfthree4nthreenine5four,5,5,55,44485
815,kpsbqshc21dzrpktfseven,2,1,21,44506
816,cdfsszrtpnsfhgsix9bzqjdltbtzjsz,9,9,99,44605
817,twofive4eighttxjxoneeightninet,4,4,44,44649
818,six4tppbxfiveblktrzgdvks1,4,1,41,44690
819,eightzmvmdbbfnft2,2,2,22,44712
820,7npgl9vvtdl2,7,2,72,44784
821,3twoone,3,3,33,44817
822,seventhree6skl,6,6,66,44883
823,onepdfjql18nine631,1,1,11,44894
824,jpjtvxck3sncsvnsix112,3,2,32,44926
825,njrkcgznhvfour1,1,1,11,44937
826,gfmtkdr2pvvlnh9one2qgvmxfm,2,2,22,44959
827,4jfxzmcdonep,4,4,44,45003
828,one9threenine,9,9,99,45102
829,544,5,4,54,45156
830,one5sevenzhmljdbfb8pncqtdkch,5,8,58,45214
831,nine72eightxvjtrbzpzvcqvlone,7,2,72,45286
832,sixfive8hpnvvjzld4,8,4,84,45370
833,24f8,2,8,28,45398
834,6bqtwothreectlcqkkzfiveppvbgbvspncldjhb,6,6,66,45464
835,ljmrlhxvsone1qdsfhqqqlljd6seven2one,1,2,12,45476
836,mfksxgxhrqxbtg73r1eight,7,1,71,45547
837,ztwogdpcgllnpp516ztdkj,5,6,56,45603
838,two8fivefourbs5jlzfnleightwoqvk,8,5,85,45688
839,seven5qnrvpqtrvlt4,5,4,54,45742
840,ninedbnd8mrchlnineqhhqjnznts,8,8,88,45830
841,onethreezmhshprm2jb98three,2,8,28,45858
842,3sixfivesix,3,3,33,45891
843,two6dfgpzqrhzp8z368,6,8,68,45959
844,twoonesixfscgflrlkmbtmv5893,5,3,53,46012
845,fiveninegkfbgczqjhnine7g,7,7,77,46089
846,rbvknineflmkl4btbqbkpsd1eight4,4,4,44,46133
847,39324,3,4,34,46167
848,sjrgxtxppvxsseveneight4fourkdcdsmfhnnqjpbtxg,4,4,44,46211
849,6threevcgjmclnhcfxvvbncnhjkmmsqqhqffivetwo4,6,4,64,46275
850,foursix1four,1,1,11,46286
851,zbztwoxptgdffourgzgzzhhmhg78ljlchqh,7,8,78,46364
852,dcpbt25vcdf3three611,2,1,21,46385
853,v58dtgrpl,5,8,58,46443
854,rntgtrrc67mdlfxzgkvjjpqtfournineninefour,6,7,67,46510
855,lpcts8vjznknlj,8,8,88,46598
856,bpmv3,3,3,33,46631
857,5z,5,5,55,46686
858,zmsevenbnckdjhpbsvglrfsskcsevenfour2nine,2,2,22,46708
859,6threesevenprcjlk5644,6,4,64,46772
860,nineczcd6922,6,2,62,46834
861,2vksfctzbjz,2,2,22,46856
862,kz93,9,3,93,46949
863,twopfhlqplngsj6z13four,6,3,63,47012
864,8nm3sevenxqzj,8,3,83,47095
865,cjgoneightthree5kmpndvrmkljeight6sflmeight,5,6,56,47151
866,three3b3seven55xgrrkssnzsghd,3,5,35,47186
867,5lvxlnpc24fbrbtg5,5,5,55,47241
868,7qgmhfnine,7,7,77,47318
869,sixpbvfjzkdsqdpsthreekj91nine,9,1,91,47409
870,sbmxhcxonefggt4f95oneseven,4,5,45,47454
871,onemgkvjpgfdjmhcsxsmlfjgzqqrftgxgx2jdmbvbfdf4,2,4,24,47478
872,bvzcskfrlg8jseight,8,8,88,47566
873,hzltjqmxjt98eightfseven,9,8,98,47664
874,2seven7vbfm44four,2,4,24,47688
875,3bvfnine,3,3,33,47721
876,4mqprdhhrdqz,4,4,44,47765
877,twothree2,2,2,22,47787
878,seven3threeeightsllttbrdcthree,3,3,33,47820
879,gmpxgkvv4four,4,4,44,47864
880,vntmvnd4two,4,4,44,47908
881,fqhvkqrxdtwo1threeqrmg5,1,5,15,47923
882,5f,5,5,55,47978
883,fivenscdbpvlz1,1,1,11,47989
884,vzdcg921fivelplfsbdccrsdsq,9,1,91,48080
885,sixnine2rnrdqkfpmdfives2,2,2,22,48102
886,5seveneight4sr9gffive,5,9,59,48161
887,hknjrm5eight34nine,5,4,54,48215
888,7965,7,5,75,48290
889,2t34two73xlfzpd,2,3,23,48313
890,626,6,6,66,48379
891,1kdfnbjgtshsonenine1eight1kzp,1,1,11,48390
892,two8mxrlgchctdtflkknonezstpfgxsdx28,8,8,88,48478
893,sixfdjgvfm1sevengg656vqcql,1,6,16,48494
894,threesevenbjcfxlbml8lhxjmzgspfour,8,8,88,48582
895,4phlqzbhvk5four,4,5,45,48627
896,1lkccpmxmlxlqrxzz8lkmbpmdncgpzsxgqdcb,1,8,18,48645
897,klqcnhjvone75,7,5,75,48720
898,5two7,5,7,57,48777
899,2ninecgrltzpgzpfourfour47seven,2,7,27,48804
900,threeoneeight758threegtwo,7,8,78,48882
901,54j,5,4,54,48936
902,seven9lqbfgrsthreefivefour,9,9,99,49035
903,six7kjm2fzcrdeightfour84,7,4,74,49109
904,four198766,1,6,16,49125
905,six3mfgmcrmlnine6lhddlhgl9,3,9,39,49164
906,rkpksqvfiverxvbseven7,7,7,77,49241
907,734six,7,4,74,49315
908,five5one9qd4bkgfdjgtxzlxfjr,5,4,54,49369
909,17eightsmjzbgdbd2nine,1,2,12,49381
910,eightqnthjhlnfive7nddfjcxq,7,7,77,49458
911,fourxkn6two6three5,6,5,65,49523
912,twoseven2,2,2,22,49545
913,eightrbhdkpxpbsvmfivethreetwox4f,4,4,44,49589
914,4bpgpdngvnineh,4,4,44,49633
915,lvpxjhgkz77pthnktwomvonekjvkkbr,7,7,77,49710
916,gqpcqlzfive2threejfknlchf,2,2,22,49732
917,zgjslb74two,7,4,74,49806
918,sixhxmt4,4,4,44,49850
919,4bcqxrcf,4,4,44,49894
920,onesix59jktnrtlone9one,5,9,59,49953
921,9seven1msixkhxbkgbnqkpfjrr,9,1,91,50044
922,four1lhslrtdrnxxsmptbjjgj5,1,5,15,50059
923,eightcvbzqczt9ninegxlpsevenfour,9,9,99,50158
924,threenine2foursixtwo2bldhzmsdvj,2,2,22,50180
925,two8dmzmbnkjqfdqtmzxndrsnkrvdnl,8,8,88,50268
926,9lqtcrvkvhdkmbfivenine6tkqh,9,6,96,50364
927,foureightjdpqhldvzeight17vbkmjvfs,1,7,17,50381
928,vkzvsphbltfxjfxxsl9,9,9,99,50480
929,shdgdlft27,2,7,27,50507
930,87twopsix7eightwoj,8,7,87,50594
931,57threeone,5,7,57,50651
932,pshspdc9fourone5eight79sxrjkcmcb,9,9,99,50750
933,sevenhmzvvbpdktxxjrlvntx1,1,1,11,50761
934,ninethreendlnnine9,9,9,99,50860
935,nine2tkmkrpccone,2,2,22,50882
936,7sixsixvdv,7,7,77,50959
937,vpktkldsjcpsxjztmthree3onefdbcxkrvhcm,3,3,33,50992
938,9lqmbltfoursnsbrqn22sdnrpxfsjfour,9,2,92,51084
939,five8mgctnvstcone24fcfbcqtknjmddknkzeightwod,8,4,84,51168
940,8xfbqxtwonmjthm24twofivelckrr,8,4,84,51252
941,xhnldpddxcjnm5twoddtqkqd,5,5,55,51307
942,sevensixdrcvgfxqpmvrtmgqdjqvclgnqjsfhnbbs3jvxnmjqcbtshp,3,3,33,51340
943,mfour1zcpnpfcdeight,1,1,11,51351
944,6twofour,6,6,66,51417
945,r1seven7tdjgxshntl,1,7,17,51434
946,eight5sixh,5,5,55,51489
947,xntwonetwofqpxsgshnbhjcsrld75fourfjbllqscg,7,5,75,51564
948,three3vbvqklcp7pfkngtnineslmrlq,3,7,37,51601
949,7six3onenmttntsfq3,7,3,73,51674
950,fivefive1seveneight,1,1,11,51685
951,p2rpjkcpcsix75fivednd,2,5,25,51710
952,ninekkzpsone167hnqlhvmtbffive,1,7,17,51727
953,2qmtbkslqgjkrqhnine3eightonefour,2,3,23,51750
954,2nlfivefive6,2,6,26,51776
955,xjvbkbtdqhgvsseven719fiveseven,7,9,79,51855
956,prbtnineqdvknxkblzgj7,7,7,77,51932
957,lkgvhtfreightninegtfrmqhd4njvsgdrhdqfxrjrcvvcz4zs,4,4,44,51976
958,25four24dhqqkpbprx,2,4,24,52000
959,29two,2,9,29,52029
960,7xsbfsfivexrrxhthree,7,7,77,52106
961,fivesrnvbdtnqnfourninelctfnxkbtv6eight,6,6,66,52172
962,9kkpzgthree1stb,9,1,91,52263
963,sevenhzxdbbb81one,8,1,81,52344
964,2jszvqhv,2,2,22,52366
965,zkvq25sj2,2,2,22,52388
966,hxxfg4kqjbjpjczzddrx9spkgdcvcsvmblvfxxcn,4,9,49,52437
967,486l2clmtcgfive47,4,7,47,52484
968,dfhkfnfour76,7,6,76,52560
969,52hnpcc,5,2,52,52612
970,kmktwonejdpgch9tthree,9,9,99,52711
971,x6bkqrlhhcm96,6,6,66,52777
972,tf7kndclhgjsoneoneightxcx,7,7,77,52854
973,mdzmsfkl5pnine8,5,8,58,52912
974,ghzv2three,2,2,22,52934
975,vctrqxfsxhtblghfchthzhninefk3eightqjjjjg,3,3,33,52967
976,three2jmvkmfour,2,2,22,52989
977,rlkbtjpnlctsxpfp521rxbjdfsixhvp1,5,1,51,53040
978,7vxlkff32mdfsqrmbnmtwotwo2nine,7,2,72,53112
979,gl6seven35two1,6,1,61,53173
980,two2rjtvndrzvthreethree,2,2,22,53195
981,tjpxszlthree54hsftvc,5,4,54,53249
982,jsthree48,4,8,48,53297
983,seven6fourtwotwo,6,6,66,53363
984,threetpnh5ninernztgb,5,5,55,53418
985,18pvqllhjf5eight9vldjjqcjfmlhnddone,1,9,19,53437
986,two9nine6hgbprcpxvmntdjkfivetwonept,9,6,96,53533
987,7four8eightktlhdpmptone,7,8,78,53611
988,rrzbgtfrrqkspsix3rkpzddzrbcrzvxzstjbqhmqq,3,3,33,53644
989,84qxbnxdpqppjfiveeightfive,8,4,84,53728
990,n6two1brpjhf,6,1,61,53789
991,plmkvpjbqr1,1,1,11,53800
992,sixsixqbksfrndvg42hclgpgfggpxmts9,4,9,49,53849
993,1htlmmvbnsix,1,1,11,53860
994,dleightwolvbvmsggs9njseven5fivethreenine,9,5,95,53955
995,eight6kxqqdnqp,6,6,66,54021
996,5eightgdvgthfiveshthreesixfive,5,5,55,54076
997,6seventntzffjkkvvhtgtwoonethreefivekzvptvxfjg,6,6,66,54142
998,three6blrfsgdqsxgkbqj3,6,3,63,54205
999,eight1eighteight8,1,8,18,54223
1000,8four419eighteight1bpv,8,1,81,54304
